#########
#P      #
#       #
#       #
#       #
#       #
#       #
#      G#
#########
